{
    "name": "チュートリアル11",
    "stage_id": "tutorial_11",
    "info" : "周りを見てみよう3",
    "level" : 4,
    "mode" : "gethart",
    "get_hart_value" : 1,
    "block_limit" : 12,
    "load_workspace" : "03.xml",
    "map_size_x": 15,
    "map_size_y": 17,
    "map_data":[[0,0,0,0,0,0,0,0,0,0,0,0,0,0,0],
                [0,0,0,0,0,0,0,0,0,0,0,0,0,0,0],
                [0,0,0,0,0,0,0,0,0,0,0,0,0,0,0],
                [0,0,1,1,1,1,1,1,1,1,1,1,0,0,0],
                [0,0,1,0,0,0,0,0,0,0,0,1,0,0,0],
                [0,0,1,0,1,1,1,1,1,1,0,1,0,0,0],
                [0,0,1,0,1,0,0,0,0,1,0,1,0,0,0],
                [0,0,1,0,1,0,0,0,0,1,0,1,0,0,0],
                [0,0,1,2,1,0,0,0,0,1,3,1,0,0,0],
                [0,0,1,1,1,0,0,0,0,1,1,1,0,0,0],
                [0,0,0,0,0,0,0,0,0,0,0,0,0,0,0],
                [0,0,0,0,0,0,0,0,0,0,0,0,0,0,0],
                [0,0,0,0,0,0,0,0,0,0,0,0,0,0,0],
                [0,0,0,0,0,0,0,0,0,0,0,0,0,0,0],
                [0,0,0,0,0,0,0,0,0,0,0,0,0,0,0],
                [0,0,0,0,0,0,0,0,0,0,0,0,0,0,0],
                [0,0,0,0,0,0,0,0,0,0,0,0,0,0,0]],
    "cool_x": 10,
    "cool_y": 8,
    "turn":100
}