{
    "name": "チュートリアル12",
    "stage_id": "tutorial_12",
    "info" : "周りを見てみよう4",
    "level" : 4,
    "mode" : "gethart",
    "get_hart_value" : 28,
    "block_limit" : 20,
    "load_workspace" : "03.xml",
    "map_size_x": 15,
    "map_size_y": 17,
    "map_data":[[0,0,0,0,0,0,0,0,0,0,0,0,0,0,0],
                [0,0,0,0,0,0,0,0,0,0,0,0,0,0,0],
                [0,0,0,2,2,2,0,0,0,2,2,2,0,0,0],
                [0,0,2,0,0,0,2,0,2,0,0,0,2,0,0],
                [0,2,0,0,0,0,0,2,0,0,0,0,0,2,0],
                [0,2,0,0,0,0,0,0,0,0,0,0,0,2,0],
                [0,0,2,0,0,0,0,0,0,0,0,0,2,0,0],
                [0,0,0,2,0,0,0,0,0,0,0,2,0,0,0],
                [0,0,0,2,0,0,0,0,0,0,0,2,0,0,0],
                [0,0,0,0,2,0,0,0,0,0,2,0,0,0,0],
                [0,0,0,0,0,2,0,0,0,2,0,0,0,0,0],
                [0,0,0,0,0,0,2,0,2,0,0,0,0,0,0],
                [0,0,0,0,0,0,0,2,0,0,0,0,0,0,0],
                [0,0,0,0,0,0,0,3,0,0,0,0,0,0,0],
                [0,0,0,0,0,0,0,0,0,0,0,0,0,0,0],
                [0,0,0,0,0,0,0,0,0,0,0,0,0,0,0],
                [0,0,0,0,0,0,0,0,0,0,0,0,0,0,0]],
    "cool_x": 7,
    "cool_y": 13,
    "turn":100
}